11111111111111111111111
10000000000100000000001
1000P000000100C00000001
11111111011100000000001
11111111011100000000001
100000000001000000C0001
10000000000100000000001
11111111011100000000001
10000000000100000000001
100000000001000000000E1
11111111111111111111111