11111111111111111111111
10000000000100000000001
10000000000100C00000001
11111111011100000000001
11111111011100000000001
1000000P000100000000001
10000000000000000000001
11111111111100000000001
10000000000000000000001
1000E000000100000000001
11111111111111111111111